00000000000000000000000000000000000000000000000000
00000000130001223000000000000000000000000000000000
00000000000000000000000000000012300000000000000000
00001300000000000000000000000000000000130000000000
00000000000000122300000000000000000000000000000000
00000000000000000000013000000000000130000130000000
00000000000000000000000000000122300000000130000000
00000000000000000000012223000000000000000130000000
00122234412300000012000000000000000000012312300000
00677785567800012300000000000000000000012312300000
