00000000000000000000000000000000000000000000000000
00000000130000000000000000000000000000000000000000
00000000000000000000000000000000000000000000000000
00001300000000000000000000000000000000000000000000
00000000000000000000000000000000000000000000000000
00000000013000000000000000000000000000000000000000
00000000000000000000000000000122300130012230000000
00000130000000000000122223000000000000000000000000
00000000000000012300000000000000000000000000012230
00122230012300000000000000000000000000000000000000