00000000000000000000000000000000000000000000000000
00000000130000000000000000000000000000000000000000
00000000000000000000000000000012300000000000000000
00001300000000000000000000000000000000000000000000
00000000000000000000000012300000000000000000000000
00000000013000000000000000000000000130000130000000
00000000000000000000000000000122300000000130000000
00000130000000000000122223000000000000000130000000
00000000000000012300000000000000000000012312300000
00122230012300000000000000000000000000012312300000