0000000000000
0000000000000
1222230000000
0000000000000
0000001222223
1222230000000
0000000000000
0000000000000
0000000000000
0000000000000