00000000000000000000000000000000000000000000000000
00000000130001223000000000000000000000000000000000
000000000000000A0000000000000012300000000000000000
0000130000000x0000x0000000000000000000130000000000
00000000000000122300000000000000000000000000000000
000000000000000000000130A0000000000130000130000000
0000000000A000000000x00000x01223000000000130000000
00000000x000x0000000012223000000000000000130000000
00122234412300000012000000000000000000012312300000
00677785567800012300000000000000000000012312300000
